WWWWWWWWWWWWWWWWWWWWWWWWWWWWWWWWWWWWWWWW
WGGGGGGGGGGGGGGGGGGGGGGGGGGGGGGGGGGGGGGW
WGGGGGGGGGGGGGGGGGGGGGGGGGGGGGGGGGGGGGGW
WGGGSSSSSSSGGGGGGGGGGGTGGGGTGGGGGTGGGGGW
WGGGSFFFFFSGGGGGGGGGGGGGGGGGGGGGGGGGGGGW
WGGGSFNFFFSGGGGGGGGGGGGGGGGGGGGGGGGGGGGW
WGGGSFfFFFSGGGGGGGGGGGGGGGGGGGGGGGGGGGGW
WGGGSSSFSSSGGGGGGGGGGGGGGGGGGGGGGGGGGGGW
WGGGGGGFGGGGGGGGGGGGGGGGGGGGGGGGGGGGGGGW
WGGGGGGFPPPPPPPPPPPPPPPPPPPPPPPPGGGGGGGW
WGGGGGGFGGGGGGGGGGGGGGGGGGGGGGGGGGGGGGGW
WGGGGGGGGGGGGGGXGGGGGGGGGGGGGGGGGGGGGGGW
WGGGGGGGGGGGGGGGGGGGGGGGGGGGGGGGGGGGGGGW
WGGGGGGGGGGGGGGGGGGGGGGGGGGGGGGGGGGGGGGW
WGGGGGGGGGGGGGGGGGGGGGGGGGGGGGGGGGGGGGGW
WGGGGGGGGcGGGGGGGGGGcGGGGGGGGGGGGGGGGGGW
WGGGGGGGGGGGGGGGGGGGGGGGGGGGGGGGGGGGGGGW
WGGGGGGGcGGGGGGGGGGGGGGGGGGGGGGGGGGGGGGW
WGGGGGGGGGGGGGcGGGGGGGGGGGGGGGGGGGGGGGGW
WGGGGGGGGGGGGGGGGGGGGGGGGGGGGGGGGGGGGGGW
WGGGGGGGGGGGGGGGGGGGGGGGGGGGGGGGGGGGGGGW
WGGGGGGGGGGTGGGGGTGGGGTGGGGGGGGGGGGGGGGW
WGGGGGGGGGGGGGGGGGGGGGGGGGGGGGGGGGGGGGGW
WGGGGGGGGGGGGTGGGGGTGGGGTGGGGGGGGGGGGGGW
WGGGGGGGGGGGGGGGGGGGGGGGGGGGGGGGGGGGGGGW
W_GGGGGGGGGGGGGGGGGGGGGGGGGGGGGGGGGGGGGW
W__GGGGGGGGGGGGGGGGGGGGGGGGGGGGGGGGGGGGW
WWWWWWWWWWWWWWWWWWWWWWWWWWWWWWWWWWWWWWWW
