WWWWWWWWWWWWWWWWWWWWWWWWWWWWWWWWWWWWWWWWWWWWWWWWWWWWWWWWWWWW
WGGGGGGGGGGGGGGGGGGGGGGGGGGGGGGGGGGGGGGGGGGGGGGGGGGGGGGGGGGW
WGGGGGGGTGGGTGGGTGGGTGGGTGGGTGGGTGGTGGGGTGGGTGGGTGGGTGGGGGGW
WGGSSSSSGGGGGGGGGGGGGGTGGGGTGGGGGTGGGGGTGGGGGTGGGGTGGGGTGGGW
WGGSFFFSGGGGGGGGGGGGGGGGGGGGGGGGGGGGGTGGGGTGGGTGGGTGGGTGGGGW
WGGSFFFSGGGGGGGGGGGGGGGGGGGGGGGGGGGGGGGTGGGGTGGGTGGGTGGGGGGW
WGGSSFSSGGGGGSSSGGGGGGGGGGGGGGGGGGGGGGGGGGGGGGGGGGGGGGGGGGGW
WGGGGGGGGGGGGSFSGGGGGGGGGGGGGGGGGGGGGGGGGGGGGGGGGGGGGGGGGGGW
WGGGGGGGGGSSSSFSGGGGGGGGGGGGGGGGGGGGGGGGGGGGGGGGGGGGGGGGGGGW
WGGGGGGGGGSFNFSGGGGGGGGGGGGGGGGGGGGGGGGGGGGGGGGGGGGGGGGGGGGW
WGGGGGGGGGSFfFSGGGGGGGGGGGGGGGGGGGGGGGGGGGGGGGGGGGGGGGGGGGGW
WGGGGGGGGGSSFSSGGGGGGGGGGGGGGGGGGGGGGGGGGGGGGGGGGGGGGGGGSGGW
WGGGGGPPPPPPPPPPPPPPPPPPPPPPPPPPPPPPPPPPPPPPPPPPPPPPPPPPGGGW
WGGGGGGGGGGGGGGGGGGGGGGGGGGGGGGGGGGGGGGGGGGGGGGGGGGGGGGGSGGW
WGGGSSSSSGGGGGGGGGGGGGGGGGGGGGGGGGGGGGGGGGGGGGGGGGGGGGGGGGGW
WGGGSFFFSGGGGGGXGGGGGGGGGGGGGGGGGGGGGGGGGGGGGGGGGGGGGGGGGGGW
WGGGSFFFSGGGGGGGGGGGGGGGGGGGGGGGGGGGGGGGGGGGGGGGGGGGGGGGGGGW
WGGGSSFSSGSSSSSGGGGGGGGGSSSGGGGGGGGGGGGGGGGGGGGGGGGGGGGGGGGW
WGGGGGGGGGSFFFSGGGGGGGGGSFSGGGGGGGGGGGGGGgGGGGGGgGGGGGGGGGGW
WGGGGGGGGGSFfFSGGGGGGGGGSFSGGGGGGGGGGGGGGGGGgGGGGGGGGGGGGGGW
WGGGGGGGGGSSFSSGGGGGGGGGGGGGGGGGGGGGGGGGGGGGGGGGGGgGGGGGGGGW
WGGGGGGGGcGGGGGGGGGGGcGGGGGGGGGGGGGGGGGGGGgGGGGGGGGGGGGGGGGW
WGGGSSSGGGGGGGGGGGGGGGGGGGGGGGGGGGGGGGGGGGGGGGgGGGGGGGGGGGGW
WGGGSFSGGGGGGGGGGGGGGGGGGGGGGGGGGGGGGGGGGGGGGGGGGGGGGGGGGGGW
WGGGSFSGGGGTGGGGGTGGGGGTGGGGGGGGGGGGGGGGGGGGGGGGGGGGGGGTGGGW
W____GGGTGGGGGTGGGGGTGGGGGTGGGTGGGGGTGGGGGTGGGGGGGTGGGGGGGGW
W_____GGGGGGGGGGGGGGGGGGGGGGGGGGGGGGGGGGGGGGGGGGGGGGGGGGGGGW
W______GGGGGGGGGGGGGGGGGGGGGGGGGGGGGGGGGGGGGGGGGGGGGGGGGGGGW
W_______GGGGGGGGGGGGGGGGGGGGGGGGGGGGGGGGGGGGGGGGGGGGGGGGGGGW
WWWWWWWWWWWWWWWWWWWWWWWWWWWWWWWWWWWWWWWWWWWWWWWWWWWWWWWWWWWW
